#######################
#**********#**********#
#@###*####*#*####*###@#
#*###*####*#*####*###*#
#*********************#
#*###*#*#######*#*###*#
#*****#*#######*#*****#
#####*#****#****#*#####
#####*####-#-####*#####
#####*#---------#*#####
#####*#-###-###-#*#####
-----*--#MM-MM#--*-----
#####*#-#######-#*#####
#####*#---------#*#####
#####*#-#######-#*#####
#####*#-#######-#*#####
#**********#**********#
#*###*####*#*####*###*#
#@**#******C******#**@#
###*#*#*#######*#*#*###
#*****#****#****#*****#
#*########*#*########*#
#*########*#*########*#
#*********************#
#######################